Mula sa https://tl.wikipedia.org/wiki/Talaan_ng_mga_salitang_hiniram_ng_Tagalog

Abante 	Avante 	Pasulong, Pausad
Abelyana[11] 	Avellana 	
Abiso 	Aviso 	Babala
Ahedres 	Ajedrez 	
Ahente 	Agente 	Kinatawan
Alemanya 	Alemania 	
Amarilyo 	Amarillo 	Dilaw
Antena 	Antena 	
Aparador 	Aparador 	
Asoge (Hg) 	Azogue 	
Asul 	Azul 	Bughaw
Asupre (S) 	Azufre 	Sangyawa
Atenas 	Atenas 	
Baryo 	Barrio 	Barangay, Bukid, Nayon
Baso 	Vaso 	
Basura 	Basura 	Kalat, Dumi
Bentilador 	Ventilador 	
Bisagra 	Bisagra 	
Bisikleta 	Bicicleta 	
Bruha 	Bruja 	Mangkukulam
Bulsa 	Bolsa 	
Busina 	Bocina 	
Britanya 	Bretaña 	
Datos 	Datos 	
Departamento 	Departamento 	Kagawaran
Dinero 	Dinero 	Pera, salapi
Deskaril 	Descarrilar 	
Diyos 	Dios 	Panginoon
Duwende 	Duende 	
Diyaryo 	Diario 	Pahayagan
Ebanghelyo 	Evangelio 	Mabuting Balita
Edad 	Edad 	Gulang
Ekolohiya 	Ecología 	
Ekonomiya 	Economía 	Kabuhayan, Pagtitipid, Katipiran
Ekwador 	Ecuador 	
Elyo (He) 	Helio 	
Embahada 	Embajada 	Pasuguan
Embahador 	Embajador 	
Ensalada 	Ensalada 	
Eroplano 	Aeroplano 	
Espada 	Espada 	
Espanyol/Español 	Español 	Tabak
Espongha 	Esponja 	
Estados Unidos 	Estados Unidos 	
Estadistika 	Estadística 	
Estupido 	Estúpido 	Tanga
Garahe 	Garaje 	Taguan
Gasolina 	Gasolina 	
Gastos 	Gastos 	
Gitara 	Guitarra 	
Gobyerno 	Gobierno 	Pamahalaan
Gwapo 	Guapo 	Makisig, Magandang lalaki
Giyera 	Guerra 	Digmaan
Hapon 	Japón 	
Hapones 	Japonés 	
Hardin 	Jardín 	Halamanan
Hardinero 	Jardinero 	
Hepe 	Jefe 	
Heringgilya 	Jeringuilla 	
Huwes 	Juez 	Hukom, tagahatol
Idroheno (H) 	Hidrógeno 	
Industriya 	Industria 	
Ingles 	Inglés 	
Inglatera 	Inglaterra 	
Intindi 	Entiende 	Unawa
Kalabasa 	Calabaza 	
Kaloriya 	Caloría 	
Kamelyo 	Camello 	
Kampeon 	Campeón 	
Kandidato 	Candidato 	
Kapasidad 	Capacidad 	Kakayahan
Kapilya 	Capilla 	
Keso 	Queso 	
Kloro (Cl) 	Cloro 	
Kobalto (Co) 	Cobalto 	
Kolehiyo 	Colegio 	Dalubhasaan
Kolesterol 	Colesterol 	
Konstitusyon 	Constitución 	Saligang Batas
Kontrabando 	Contrabando 	
Konsepto 	Concepto 	Dalumat
Kordero 	Cordero 	Batang tupa
Korte 	Corte 	Hukuman
Kotse/Awto 	Coche/Auto 	Sasakyan
Kumusta 	¿Cómo está? 	
Kweba 	Cueva 	Yungib
Kwenta 	Cuenta 	Bayarin
Lapis 	Lápiz 	
Libra 	Libra 	
Lingguwistika 	Lingüística 	Dalubwikaan
Loko 	Loco 	Baliw, sira-ulo
Lugar 	Lugar 	Pook
Luho 	Lujo 	Rangya, Karangyaan
Maleta 	Maleta 	
Mani 	Maní 	
Mantika 	Manteca 	
Mantsa 	Mancha 	
Margarina 	Margarina 	
Matematika 	Matemática 	Sipnayan
Matematiko 	Matemático
Memorya 	Memoria 	Alaala, Gunita
Militar 	Militar 	Hukbo, Sandatahan
Minuto 	Minuto 	
Miyembro 	Miembro 	Kasapi, Kagawad
Monarkiya 	Monarquía 	Kaharian
Motorsiklo 	Motocicleta 	
Musika 	Música 	Tugtugin
Mustasa 	Mostaza 	
Nasyonalista 	Nacionalista 	Makabayan, Makabansa
Obispo 	Obispo 	
Oksiheno (O) 	Oxígeno 	
Olanda 	Holanda 	
Onsa 	Onza 	
Opisyal 	Oficial 	
Otel 	Hotel 	
Pabrika 	Fábrica 	Pagawaan
Pamilya 	Familia 	
Panderetas 	Panderetas 	
Pantalon 	Pantalón 	
Papel 	Papel 	
Parol 	Farol 	
Parke 	Parque 	Liwasan
Pasaporte 	Pasaporte 	
Payaso 	Payaso 	Lukayo
Pelikula 	Película 	
Pilduras 	Píldoras 	
Pilipinas 	Filipinas 	
Piso 	Peso 	
Porke 	Porque 	Kasi
Probinsiya 	Provincia 	Lalawigan
Presidente 	Presidente 	Pangulo
Presko 	Fresco 	Sariwa
Protina 	Proteina 	
Pulgada 	Pulgada 	
Pulisya 	Policía 	
Puwede 	Puede 	Kaya, Maaarì
Puwera[12] 	Fuera 	Maliban sa, Maliban kay
Radyo 	Radio 	
Realidad 	Realidad 	Katunayan, Katotohanan
Relo, Relos, Rilos 	Reloj 	Orasan
Republika 	República 	
Sabadista 	Sabadista 	
Sapatos 	Zapatos 	
Sardinas 	Sardinas 	
Sarado 	Cerrado 	Nakapinid
Selyo 	Sello 	Tatak
Sentimyento (o "senti") 	Sentimiento 	
Senyales 	Señales 	Tanda
Sikolohiya 	Psicología 	
Sink (Zn) 	Zinc 	
Simple 	Simple 	Payak
Sipilyo 	Cepillo 	
Siyensya 	Ciencia 	Agham
Siyudad 	Ciudad 	Lungsod
Sundalo 	Soldado 	Kawal
Sustansya 	Sustancia 	
Sustento 	Sustento 	
Suweldo 	Sueldo 	Sahod
Tableta 	Tableta 	
Tangke 	Tanque 	
Tarheta 	Tarjeta 	
Tasa 	Taza 	
Teklado 	Teclado 	Tipaan (karaniwan para sa kompyuter)
Tela 	Tela 	
Telebisyon 	Televisión 	
Telepono 	Teléfono 	
Tiya 	Tía 	Tita
Tiyo 	Tío 	Tito
Tsino 	Chino 	Intsík (bahagyang mapanghamak), Tsekwa (salitang balbal)
Tsinelas 	Chinelas 	
Tisa 	Tiza 	Yeso
Tsismis 	Chismes 	Satsat
Tumbaga 	Tumbaga 	
Unibersidad 	Universidad 	Pamantasan
Welga 	Huelga 	
Yelo 	Hielo 	
Yodo (I) 	Yodo 	

Alahero 	Alhajero ("kahon ng alahas") 	Joyero
Algodon[27] 	Algodon ("bulak") 	Pagapa; pez blanco
Almohadilya[28] 	Almohadilla ("maliit na unan") 	Alfombrilla para el ratón o mouse
Almusal 	Almorzar ("magtanghalian") 	Desayuno
Asar[29] 	Asar ("ihawin") 	Molestar
Bahura 	Bajura ("baybayin" o "mababaw na tubig") 	Arrecife coralina
Barkada 	Barcada ("lulan ng bangka" o "biyahe sa bangka") 	Pandilla de amigos o camaradas
Basta 	Basta ("sapat") 	Siempre y cuando; siempre que
Bida 	Vida ("buhay") 	Protagonista
Biskotso 	Bizcocho ("mamon") 	Pan tostado
Bulsa 	Bolsa ("bag") 	Bolsillo
Dehado 	Dejado ("naiwan" o "walang-ingat") 	Desfavorecido; desaventajado
Delikado 	Delicado ("maselan") 	Peligroso
Dilihensiya 	Diligencia ("sipag" o "bilin") 	Pedir un préstamo
Disgrasya 	Desgracia ("kasawian") 	Accidente
Diskarte 	Descarte ("iwaksi") 	Ingeniosidad; capacidad de improvisación
Gisado 	Guisado ("nilaga") 	Salteado
Harana 	Jarana ("kaguluhan", "pakikisalu-salo" o "walang-taros na pagsasaya")
Hepe 	Jefe ("puno" o "amo") 	Comisario; jefe de policía
Impakto 	Impacto ("salpok" o "dagok") 	Espíritu maligno
Inutil 	Inútil ("walang silbi") 	Sexualmente impotente
Iskiyerda 	Izquierda ("kaliwa") 	Irse de; abandonar
Kabayo 	Caballo ("koda") 	Tabla de planchar
Kabisera 	Cabecera ("ulo" o "ulunan ng kama") 	Capital; ciudad cabecera
Kakawate 	Cacahuate ("mani") 	Madre de cacao
Kasilyas 	Casillas ("kubikulo") 	Baño
Konyo 	Coño ("salitang bulgar at masama") 	De clase alta
Kubeta 	Cubeta ("balde") 	Baño
Kulebra 	Culebra ("ahas") 	Culebrilla; herpes zóster
Kursonada 	Corazonada ("kutob") 	Deseo del corazón
Kuryente 	Corriente ("daloy") 	Electricidad; corriente eléctrica
Labakara 	Lavacara ("hilamusan") 	Toalla de tocador
Lakwatsa 	Cuacha ("dumi") 	Vaguear; holgazanear; hacer novillos
Lamyerda 	Mierda ("dumi") 	Vaguear; holgazanear; hacer novillos
Libre 	Libre ("malaya") 	Gratis
Liyamado 	Llamado ("tinawagan", "pinangalanan" o "itinalaga") Favorecido
Mantika 	Manteca ("mantikilya") 	Aceite
Muta 	Mota ("batik" o "dumi") 	Legaña
Palengke 	Palenque ("istakada" o "bakod") 	Mercado
Palitada 	Paletada ("sanpala" o "sandulos") 	Yeso
Papagayo 	Papagayo ("loro") 	Cometa
Parada 	Parada ("hinto") 	Desfile
Parol 	Farol ("ilawan", "lampara" o "ilaw sa kalye") 	Estrella navideña
Parolero 	Farolero ("tagapagsindi ng lampara") 	Artesano de estrellas navideñas
Pasamano 	Pasamano ("dalaydayan") 	Alféizar, repisa de la ventana
Pitso 	Pecho ("dibdib" o "suso") 	Pechuga de pollo
Postiso 	Postizo ("huwad" o "nababakas") 	Prótesis dental; dentadura postiza
Putahe 	Potaje ("nilagang gulay o sopas") 	Plato
Rebentador 	Reventador ("manunulsol") 	Petardo
Rekado 	Recado ("mensahe" o "bilin") 	Especia; condimiento
Ruweda[30] 	Rueda ("gulong") 	Rueda de la fortuna
Semilya 	Semilla ("binhi") 	Semen
Sentido 	Sentido ("diwa" o "kahulugan") 	Templo; sien
Siguro 	Seguro ("sigurado") 	Quizás; probablemente
Silindro 	Cilindro ("silinder") 	Armónica
Sintas 	Cintas ("laso", "teyp" o "sinturon") 	Cordón de zapato; cintas para zapatos
Siyempre 	Siempre ("palagi") 	Por supuesto
Suplado 	Soplado ("hinanginan" o "pinapintog") 	Presuntuoso, arrogante
Suporta 	Soportar ("pagtiisan") 	Apoyo
Sustansya 	Sustancia (meaning "substance") 	Sustancia nutritiva; nutriente
Tirada 	Tirada ("ihagis" o "bilang ng nalimbag") 	Diatriba
Todas 	Todas ("lahat") 	Matar
Todo 	Todo ("lahat", "buong", "bawat", atbp.) 	Al máximo
Tosino 	Tocino ("bacon") 	Carne curada endulzada
Tsamporado 	Champurrado ("atole batay sa tsokolate") 	Arroz al chocolate
Tsika 	Chica ("babae") 	Chisme
Turon 	Turrón ("nougat") 	Rollo de platano frito
Tuwalya 	Toalla ("tuwalya") 	Mondongo; tripa; callos

Alahas 	Alhaja (maramihan: alhajas) 	Alahas; hiyas
Alkatsopas 	Alcachofa (maramihan: alcachofas) 	Alkatsopas (Cynara scolymus)
Aratiles 	Dátil (maramihan: dátiles) 	Datilero (Phoenix dactilyfera)
Armas 	Arma (maramihan: armas) 	Sandata; braso
Balbas 	Barba (maramihan: barbas) 	Balbas
Banyos 	Baño (maramihan: baños) 	Banyo; paliguan
Bayabas 	Guayaba (maramihan: guayabas) 	Bayabas (Psidium guajava)
Beses 	Vez (maramihan: veces) 	Beses
Boses 	Voz (maramihan: voces) 	Boses; tinig
Butones (bar. bitones) 	Botón (maramihan: botones) 	Butones
Datos 	Dato (maramihan: datos) 	Katotohanan; detalye; piraso ng impormasyon; datos
Garbansos 	Garbanzo (maramihan: garbanzos) 	Garbansos (Cicer arietinum)
Gastos 	Gasto (maramihan: gastos) 	Gastos; gugol; paggasta
Gisantes 	Guisante (maramihan: guisantes) 	Tsitsaro (Pisum sativum)
Guwantes 	Guante (maramihan: guantes) 	Guwantes
Kalatas[32] 	Carta (maramihan: cartas) 	Sulat; talangguhit; karta
Kamatis 	Tomate (maramihan: tomates) 	Tomato (Lycopersicum esculentum)
Kasilyas 	Casilla (maramihan: casillas) 	Kubikulo; kubol
Kastanyas 	Castaña (maramihan: castañas) 	Kastanyas (Castanea spp.)
Kostilyas 	Costilla (maramihan: costillas) 	Rib
Kubyertos 	Cubierto (maramihan: cubiertos) 	Kubyertos
Kuwerdas 	Cuerda (maramihan: cuerdas) 	Lubid; tali; kuwerdas
Kuwintas 	Cuenta (maramihan: cuentas) 	Hiyas
Kuwitis 	Cohete (maramihan: cohetes) 	Kuwitis
Labanos 	Rabano (maramihan: rabanos) 	Labanos (Raphanus sativus)
Lansones 	Lanzón[33] (maramihan: lanzones) 	P. Kast. para sa Lansium domesticum
Letsugas 	Lechuga (maramihan: lechugas) 	Lettuce (Lactuca sativa)
Manggas 	Manga (maramihan: mangas) 	Manggas
Mansanas 	Manzana (maramihan: manzanas) 	Mansanas (Malus domestica)
Materyales 	Material (maramihan: materiales) 	Materyales
Medyas 	Media (maramihan: medias) 	Medyas
Opisyales 	Oficial (maramihan: oficiales) 	Opisyales
Oras 	Hora (maramihan: horas) 	Oras (sukat ng panahon)
Panderetas 	Pandereta (maramihan: panderetas) 	Panderetas
Palanas[32] 	Plana (maramihan: planas) 	Kapatagan
Papeles 	Papel (maramihan: papeles) 	Papel
Patatas 	Patata (maramihan: patatas) 	Patatas (Solanum tuberosum)
Pares 	Par (maramihan: pares) 	Pair
Pasas 	Pasa (maramihan: pasas) 	Pasas
Pastilyas 	Pastilla (maramihan: pastillas) 	Pilduras; tableta; kendi
Peras 	Pera (maramihan: peras) 	Peras (Pyrus spp.)
Perlas 	Perla (maramihan: perlas) 	Perlas
Pilduras 	Pildora (maramihan: pildoras) 	Pilduras; tableta
Pohas 	Foja (maramihan: fojas) 	Pohas
Posas 	Esposa (maramihan: esposas) 	Posas
Presas 	Presa (maramihan: presas) 	Presas (Fragaria x ananassa)
Prutas 	Fruta (maramihan: frutas) 	Prutas
Pulbos 	Polvo (maramihan: polvos) 	Alikabok; pulbos
Pulseras 	Polvo (maramihan: pulseras) 	Pulseras
Puntos 	Punto (maramihan: puntos) 	Tuldok; punto; puntos (paligsahan)
Rehas 	Reja (maramihan: rejas) 	Rehas
Riles 	Carril (maramihan: carriles) 	Landas; daanan
Rosas 	Rosa (maramihan: rosas) 	Rose (Rosa spp.)
Salas 	Sala (maramihan: salas) 	Sala
Sapatos 	Zapato (maramihan: zapatos) 	Sapatos
Sardinas 	Sardina (maramihan: sardinas) 	Sardinas (Clupeidae)
Senyales 	Señal (maramihan: señales) 	Senyas; tanda
Senyas 	Seña (maramihan: señas) 	Senyas; tanda
Sibuyas 	Cebolla (maramihan: cebollas) 	Sibuyas (Allium cepa)
Sigarilyas 	Seguidilla[34] (maramihan: seguidillas) 	P. Kast. para sa Psophocarpus tetragonolobus
Silahis[35] 	Celaje (maramihan: celajes) 	Kulumpon ng ulap
Singkamas 	Jícama (maramihan: jícamas) 	Singkamas (Pachyrhizus erosus)
Sintas 	Cinta (maramihan: cintas) 	Laso; teyp; puntas
Sintomas 	Síntoma (maramihan: síntomas) 	Sintomas
Sopas 	Sopa (maramihan: sopas) 	Sabaw
Sorbetes 	Sorbete (maramihan: sorbetes) 	Sorbetes
Tsinelas 	Chinela (maramihan: chinelas) 	Tsinelas
Tsismis 	Chisme (maramihan: chismes) 	Chismis
Ubas 	Uva (maramihan: uvas) 	Ubas (Vitis spp.)
Uhales 	Ojal (maramihan: ojales) 	Uhales
Uhas 	Hoja (maramihan: hojas) 	Dahon

Mga salitang nagmula sa mga pandiwa ng Kastila

Akusa 	Acusar 	Akusahan; paratangan
Alsa 	Alzar 	Iangat; itaas; ipatayo
Analisa 	Analizar 	Suriin
Apela 	Apelar 	Apela, mamanhik
Apruba 	Aprobar 	Magpatibay; pahintulutan
Apura 	Apurar 	Tapusin; magmadali (Lat. Am.)
Alkila (bar. arkila) 	Alquilar 	Magrenta; magparenta
Asinta 	Asentar 	Itutok sa pook; ilapag
Aturga 	Otorgar 	Ipagkaloob; ibigay; igawad
Awtorisa 	Autorizar 	Pahintulutan
Bara 	Barrar 	Putikan
Bati 	Batir 	Batihin
Beripika 	Verificar 	Patunayan
Bulkanisa 	Vulcanizar 	Bulkanisa
Bura 	Borrar 	Magbura
Burda 	Bordar 	Magburda
Deklara 	Declarar 	Magpahayag
Determina 	Determinar 	Magpasiya
Dikta 	Dictar 	Mag-utos
Dimiti 	Dimitir 	Magbitiw sa tungkulin
Dirihi 	Dirigir 	Mamahala; mangasiwa
Disapruba 	Disaprobar 	Di-sang-ayunan
Disarma 	Desarmar 	Mag-alis ng sandata
Disimpekta 	Desinfectar 	Magdisimpekta
Disimula 	Disimular 	Itago; takpan
Diskarga 	Descargar 	Alisan ng kargada; ikarga-pakuha
Diskita 	Desquitar 	Bumawi
Diskubri 	Descubrir 	Matuklasan
Dismaya 	Desmayar 	Masira ang loob; masiphayo
Distrungka 	Destroncar 	Hawanin
Galbanisa 	Galvanizar 	Galbanisahin
Gisa 	Guisar 	Maglaga
Hulma 	Ahormar 	Hugisan
Husga 	Juzgar 	Hatulan
Imbestiga 	Investigar 	Mag-imbestiga; siyasatin
Imbita 	Invitar 	Mag-anyaya
Intindi 	Entender 	Intindihin; unawain
Itsa 	Echar 	Ihagis
Kalkula 	Calcular 	Kalkulahin; tayahin
Kansela 	Cancelar 	Ikansela
Kanta 	Cantar 	Mag-awit
Karga 	Cargar 	Ikarga; punuin
Kodipika 	Codificar 	Isakodigo
Kondena 	Condenar 	Kondenahin
Konserba 	Conservar 	Makatipid
Konsidera 	Considerar 	Isaalang-alang; ituring
Kubli 	Cubrir 	Itago; itakip
Kubra 	Cobrar 	Maningil
Kula 	Colar 	Salain; Magpaputi
Kulti 	Curtir 	Magpaitim
Kumbida 	Convidar 	Mag-anyaya
Kumbinsi 	Convencir 	Kumbinsihin
Kumpara 	Comparar 	Ihambing
Kumpirma 	Confirmar 	Kumpirmahin
Kumpiska 	Confiscar 	Kumpiskahin; samsamin
Kumpuni (bar. kompone) 	Componer 	Ibuo; umakda; ayusin
Kusi 	Cocer 	Magluto
Laba 	Lavar 	Maglaba; maghugas
Legalisa 	Legalizar 	Legalisahin
Liberalisa 	Liberalizar 	Liberalisahin
Manipula 	Manipular 	Manipulahin
Marka 	Marcar 	Magmarka
Nomina 	Nominar 	Hirangin
Obliga 	Obligar 	Pilitan; obligahin
Obserba 	Observar 	Obserbahan; pagmasdan
Opera 	Operar 	Magpatakbo
Palsipika 	Falsificar 	Palsipikahin; doktorin
Palya 	Fallar 	Mabigo
Paralisa 	Paralizar 	Paralisahin
Pasa 	Pasar 	Iabot; mangyari; danasin
Pasma[40] 	Pasmar 	Magpahanga; magpamangha
Pinta 	Pintar 	Magpinta
Pirma 	Firmar 	Maglagda
Pormalisa 	Formalizar 	Gawing pormal
Prepara 	Preparar 	Maghanda
Preserba 	Preservar 	Panatilihin
Proklama 	Proclamar 	Ipahayag; iproklama
Pundi 	Fundir 	Tunawin; pagsamahin
Punta 	Apuntar 	Pumuntirya; ituro; isulat
Purga 	Purgar 	Magpurga
Pursigi 	Perseguir 	Ipagpatuloy; sundan; habulin; umusig
Pusta 	Apostar 	Pumusta; tumaya
Ratipika 	Ratificar 	Magpatibay
Reboka 	Revocar 	Bawiin
Rekomenda 	Recomendar 	Magrekomenda
Repina 	Refinar 	Pinuhin
Sangkutsa 	Sancochar o Salcochar 	Pakuluan sa tubig at asin
Salba 	Salvar 	Iligtas
Sara 	Cerrar 	Isara
Silbi 	Servir 	Maglingkod
Sindi 	Encender 	Magpaapoy; buksan
Sulda 	Soldar 	Maghinang; pagkaisahin
Sulsi 	Zurcir 	Tumahi; maghayuma
Sumite 	Someter 	Sumupil; lupigin; ipasa
Suspende 	Suspendir 	Suspindihin
Tantiya 	Tantear 	Kapain; timbangin; tantiyahin
Taranta 	Atarantar 	Magpatulala; magpasilaw
Tasa 	Tajar 	Tumaga; gupitin; hiwain
Timpla 	Templar 	Magpalamig; gawing katamtaman
Tumba 	Tumbar 	Patumbahin
Tusta 	Tostar 	Tustahin
Umpisa 	Empezar 	Magsimula

Mga salitang tambalan na may nakahalong Kastila at Tagalog

Agaw-eksena 	agaw (mula sa Tagalog) + eksena (mula sa Kast. escena)
Alsa-balutan 	alsa (mula sa Kast. alzar) + balutan (mula sa Tagalog)
Amoy-tsiko 	amoy (mula sa Tagalog) + tsiko (mula sa Kast. chicozapote)
Anemonang-dagat 	anemona (mula sa Kast. anémona) + dagat (mula sa Tagalog)
Bagong-salta 	bago (mula sa Tagalog) + salta (mula sa Kast. saltar)
Balat-sibuyas 	balat (mula sa Tagalog) + sibuyas (mula sa Kast. cebollas)
Balik-eskwela 	balik (mula sa Tagalog) + eskwela (mula sa Kast. escuela)
Bantay-sarado 	bantay (mula sa Tagalog) + sarado (mula sa Kast. cerrado)
Bigay-todo 	bigay (mula sa Tagalog) + todo (mula sa Kast. todo)
Boses-ipis 	boses (mula sa Kast. voces) + ipis (mula sa Tagalog)
Boses-palaka 	boses (mula sa Kast. voces) + palaka (mula sa Tagalog, frog)
Bugbog-sarado 	bugbog (mula sa Tagalog) + sarado (mula sa Kast. cerrado)
Bulak-niyebe 	bulak (mula sa Tagalog) + niyebe (mula sa Kast. nieve)
Dilang-anghel 	dila (mula sa Tagalog) + anghel (mula sa Kast. angel)
Dilang-baka 	dila (mula sa Tagalog) + baka (mula sa Kast. vaca)
Doble-ingat 	doble (mula sa Kast. doble) + ingat (mula sa Tagalog)
Doble-talim 	doble (mula sa Kast. doble) + talim (mula sa Tagalog)
Epikong-bayan 	epiko (mula sa Kast. poema épico) + bayan (mula sa Tagalog)
Esponghang-dagat 	espongha (from. Sp. esponja) + dagat (mula sa Tagalog)
Giyera-patani 	giyera (mula sa Kast. guerra) + patani (mula sa Tagalog)
Hating-globo 	hati (mula sa Tagalog) + globo (mula sa Kast. globo)
Hiram-kantores 	hiram (mula sa Tagalog) + kantores (mula sa Kast. cantores)
Kabayong-dagat 	kabayo (mula sa Kast. cavallo) + dagat (mula sa Tagalog)
Karnerong-dagat 	karnero (mula sa Kast. carnero) + dagat (mula sa Tagalog)
Kayod-marino 	kayod (mula sa Tagalog) + marino (mula sa Kast. marino)
Kilos-protesta 	kilos (mula sa Tagalog) + protesta (mula sa Kast. protesta)
Kuwentong-bayan 	kwento (mula sa Kast. cuento) + bayan (mula sa Tagalog)
Lakad-pato 	lakad (mula sa Tagalog) + pato (mula sa Kast. pato)
Leong-dagat 	leon (mula sa Kast. león) + dagat (mula sa Tagalog)
Mukhang-pera 	mukha (mula sa Tagalog) + pera (mula sa Kast. perra gorda o perra chica)
Pader-ilog 	pader (mula sa Kast. pared) + ilog (mula sa Tagalog)
Pampalipas-oras 	lipas (mula sa Tagalog) + oras (mula sa Kast. horas)
Panday-yero 	panday (mula sa Tagalog) + yero (mula sa Kast. hierro)
Patay-malisya 	patay (mula sa Tagalog) + malisya (mula sa Kast. malicia)
Pusong-mamon 	puso (mula sa Tagalog) + mamon (mula sa Kast. mamón)
Sanib-puwersa 	sanib (mula sa Tagalog) + puwersa (mula sa Kast. fuerza)
Siling-haba 	sili (mula sa Kast. chile) + haba (mula sa Tagalog)
Siling-labuyo 	sili (mula sa Kast. chile) + labuyo (mula sa Tagalog)
Singsing-pari 	singsing (mula sa Tagalog) + pari (mula sa Kast. padre)
Sirang-plaka 	sira (mula sa Tagalog) + plaka (mula sa Kast. placa)
Sulat-makinilya 	sulat (mula sa Tagalog) + makinilya (mula sa Kast. maquinilla)
Taas-presyo 	taas (mula sa Tagalog) + presyo (mula sa Kast. precio)
Tabing-kalsada 	tabi (mula sa Tagalog) + kalsada (mula sa Kast. calzada)
Tabing-kalye 	tabi (mula sa Tagalog) + kalye (mula sa Kast. calle)
Takaw-aksidente 	takaw (mula sa Tagalog) + aksidente (mula sa Kast. accidente)
Takaw-disgrasya 	takaw (mula sa Tagalog) + disgrasya (mula sa Kast. desgracia)
Takdang-oras 	takda (mula sa Tagalog) + oras (mula sa Kast. horas)
Takdang-petsa 	takda (mula sa Tagalog) + petsa (mula sa Kast. fecha)
Tanim-bala 	tanim (mula sa Tagalog) + bala (mula sa Kast. bala)
Tanim-droga 	tanim (mula sa Tagalog) + droga (mula sa Kast. droga)
Taong-grasa 	tao (mula sa Tagalog) + grasa (mula sa Kast. grasa)
Tubig-gripo 	tubig (mula sa Tagalog) + gripo (mula sa Kast. grifo)
Tulak-droga 	tulak (mula sa Tagalog, to push) + droga (mula sa Kast. droga)
Tulog-mantika 	tulog (mula sa Tagalog) + mantika (mula sa Kast. manteca)
Tunog-lata 	tunog (mula sa Tagalog) + lata (mula sa Kast. lata)

Ingles

Adik 	Drug addict 	Durugista (Kast. drogas + -ista)
Adyenda 	Agenda 	
Bag 	Bag 	Supot
Bakwit 	Evacuate 	Lumikas
Barbikyu 	Barbecue 	
Basketbol 	Basketball 	
Beysbol 	Baseball 	
Bilyar 	Billiard 	
Biskwit 	Biscuit 	
Bistek 	Beef steak 	
Bodabil 	Vaudeville 	
Boksing 	Boxing 	
Bolpen 	Ballpoint pen 	
Drayber 	Driver 	Tsuper (Kast. chofer)
Dyaket 	Jacket 	
Dyakpat 	Jackpot 	
Dyip/Dyipni 	Jeep/Jeepney 	
Gadyet 	Gadget 	
Gradweyt 	Graduate 	Nakapagtapos ng pag-aaral; gradwado (Kast. graduado)
Hayskul 	High school 	Paaralang sekundarya (sekundarya = Kast. secundaria); Mataas na paaralan
Helikopter 	Helicopter 	
Interbyu 	Interview 	Panayam, Entrebista (Kast. entrevista)
Internet 	Internet 	
Iskedyul 	Schedule 	Talaorasan (oras = Kast. horas)
Iskolar 	Scholar 	
Iskor 	Score 	Puntos (Kast. punto)
Iskul 	School 	Paaralan
Iskrip 	Script 	
Iskrin 	Screen 	Tabing
Iskuter 	Scooter 	
Iskuwater 	Squatter 	
Ispayral 	Spiral 	Balisungsong
Ispiker 	Speaker (tao) 	Tagapagsalita, Tagatalumpati, Mananalumpati
Isponsor 	Sponsor 	Tagatangkilik
Isport 	Sport 	Palaro, Palakasan, Paligsahan (isinasalin din bilang "timpalak" o "torneo")
Isprey 	Spray 	Wisik
Istandard 	Standard 	Pamantayan, Panukatan
Kabinet 	Cabinet 	Aparador (Kast.)
Kambas 	Canvass 	
Kapirayt 	Copyright 	Karapatang-sipi
Karot 	Carrot 	Asinorya, Asanorya
Kemikal 	Chemical 	
Kendi 	Candy 	Minatamis
Ketsap 	Ketchup 	Sarsa (Kast. salsa)
Keyk 	Cake 	
Kompyuter 	Computer 	
Korek 	Correct 	Ayos, Tama (Sans.), Tumpak
Kyut 	Cute 	Lindo (l) & Linda (b) (Kast.)
Lider 	Leader 	Pinuno
Lobat[45] 	Low battery 	
Madyik 	Magic 	Salamangka
Magasin 	Magazine 	
Miskol[45] 	Missed call 	
Miting 	Meeting 	Pulong
Nars 	Nurse 	
Okey 	OK, Okay 	Sige (Kast. sigue)
Plastik 	Plastic 	
Pulis 	Police 	
Rali 	Rally 	
Sandwits 	Sandwich 	
Tambay 	Stand by 	
Tenis 	Tennis 	
Tin-edyer 	Teenager 	Lalabintaunin
Titser 	Teacher 	Guro (Sans. "guru"), Maestro (l) & Maestra (b)(Kast.)
Tisyu 	Tissue 	
Traysikel 	Tricycle 	Trisiklo
Trey 	Tray 	
Wais 	Wise 	Mautak, Maabilidad (abilidad = Kast.)

Malay

Balaklaot[47] 	barat laut (Malay, hilagang-kanluran)
Batubalani[48] 	batu (Malay at Tagalog) + berani (Malay, matapang)
Bibingka[49] 	kuih bingka (Malay, tumutukoy sa mamon na gawa sa kamoteng-kahoy)
Bilanggo 	belenggu (Malay, posas o kadena)
Binibini[50] 	bini (Malay, asawang babae)
Bunso[51] 	bongsu (Malay, pinakabata na ipinanak)
Dalamhati 	dalam (Malay, sa loob) + hati (Malay, atay)
Dalubhasa[52] 	juru (Malay, eksperto) + bahasa (Malay, wika)
Hatol[53] 	atur (Malay, kaayusan o pagkakaayos)
Kanan[54] 	kanan (Malay, kanan)
Kawal[55] 	kawal (Malay, bantay, patrolya o tanod)
Kulambo[56] 	kelambu (Malay, moskitero)
Lagari[57] 	gergaji (Malay, serutso)
Lunggati 	lung (Tagalog - salitang ugat, lungkot[8]:88) + hati (Malay, atay)
Luwalhati 	luwal (Tagalog, sa labas) + hati (Malay, atay)
Uluhati 	ulo (Tagalog) + hati (Malay, atay)
Pighati 	pedih (Malay, sakit) + hati (Malay, atay)
Pilak[58] 	perak (Malay, plata) (Talagang nagmula sa Khmer)
Pirali[59] 	pijar (Malay, borax)
Salaghati 	salag o salak (Tagalog, puno at pinatag) + hati (Malay, atay)
Takal[60] 	takar (Malay, panukat ng kapasidad para sa langis, atbp.)
Tanghali[61] 	tengah (Malay, kalahati) + hari (Malay, araw)
Tiyanak[62] 	puntianak (Malay, tumutukoy sa bampira, multo o katawang muling-binuhay na sumisipsip ng dugo)
Usap[63] 	ucap (Malay, pagbigkas)

Sanskrito

Agham 	Āgama (आगम) 	Pagtatamo ng kaalaman; siyensiya
Antala 	Antara (अन्तर) 	Tagal; puwang
Asal 	Ācāra (आचार) 	Paraan ng pagkilos; pag-uugali, gawi
Bahala 	Bhara (भार) 	Pasan; bigat; mabigat na trabaho
Balita 	Vārtā (वार्ता) 	Salaysay; ulat
Bansa 	Vaṃśa (वंश) 	Tubo ng kawayan; talaangkanan; dinastiya; lahi
Banyaga 	Vaṇijaka (वणिजक) 	Mangangalakal; negosyante
Basa 	Vaca (वच) 	Boses; pagsasalita
Bathala 	Batthara (भट्टार) 	Taong maharlika; kagalang-galang
Bihasa 	Abhyasa (अभ्यास) 	Kinaugalian
Budhi 	Bodhi (बोधि) 	Pag-unawa
Dawa[8]:73,191 	Yava (यव) 	Hordeum vulgare
Daya 	Dvaya (द्वय) 	Pagiging dalawahang-panig; kasinungalingan
Diwa 	Jīva (जीव) 	Ang prinsipyo ng buhay; napakahalagang hininga
Diwata 	Devata (देवता) 	Pagka-diyos
Dukha 	Dukkha (दुःख) 	Kalungkutan; karalitaan; kahirapan
Dusa 	Doṣa (दोष) 	Pinsala; kasiraan; masasamang bunga
Dusta 	Dūṣita (दूषित) 	Nadungisan; nahalay; nasaktan
Gadya 	Gaja (गज) 	Elepante
Ganda 	Gandha (गन्ध) 	Bango; halimuyak
Guro 	Guru (गुरु) 	Maestro; guro
Halaga 	Argha (अर्घ) 	Halaga
Halata 	Arthaya (अर्थय) 	Maramdaman
Haraya 	Hridaya (हृदय) 	Puso
Hina 	Hīna (हीन) 	Mas mahina/mababa kaysa sa; inabandona; kulang
Hiwaga 	Vihaga (विहग) 	Ibon
Kasubha 	Kusumbha (कुसुम्भ) 	Carthamus tinctorius
Kastuli 	Kastūrī (कस्तूरी) 	Abelmoschus moschatus
Katha 	Kathā (कथा) 	Isang mapagkunwaring kuwento; pabula
Katakata 	Pag-uulit ng Kathā (कथा) 	Kuwento; pabula
Kalapati; Palapati 	Pārāpataḥ (पारापत) 	Kalapati
Kuba 	Kubja (कुब्ज) 	Kuba
Kuta 	Kota (कोट) 	Muog; kuta
Ladya 	Raja (राज) 	Hari; pinuno; soberano
Lagundi 	Nirgundi (निर्गुण्डि) 	Vitex negundo
Laho 	Rāhu (राहु) 	Eklipse
Lasa 	Rasa (रस) 	Lasa; tikman
Likha 	Lekhā (लेखा) 	Pagguhit; pigura
Madla 	Mandala (मण्डल) 	Bilog; pulutong
Maharlika 	Maharddhika (महर्द्धिक) 	Maunlad
Makata 	Tag. ma- + kathā (कथा) 	Kuwento; pabula
Mukha 	Mukha (मुख) 	Mukha
Mula 	Mula (मूल) 	Batayan; saligan; pinagmulan; pinagsimulan
Mutya 	Mutya (मुत्य) 	Perlas
Paksa 	Paksha (पक्ष) 	Isang punto o bagay na pinagtatalakayan
Palibhasa 	Paribhasa (परिभाषा) 	Pagsasalita; pamimintas; pagsumbat
Parusa 	Tag. pa- + dusa, mula sa Sanskritong doṣa (दोष) 	
Patola 	Patola (पटोल) 	Trichosanthes dioica
Saksi 	Sākṣin (साक्षिन्) 	Testigo
Sakuna 	Zakuna (शकुन) 	Isang ibong nagbabadya
Salamuha 	Samuha (समूह) 	Pagtitipon; pulutong
Salanta 	Randa (रण्ड) 	Nalumpo; baldado
Salita 	Carita (चरित) 	Ugali; mga kilos; mga gawa; pakikipagsapalaran
Samantala 	Samantara (समान्तर) 	Agapay
Sampalataya 	Sampratyaya (सम्प्रत्यय) 	Tiwala; kumpiyansa
Sandata 	Saṃyatta (संयत्त) 	Handa; nakaalisto
Sigla 	Sīghra (शीघ्र) 	Mabilis; matulin
Suka 	Cukra (चुक्र) 	Suka
Sutla 	Sūtra (सूत्र) 	Sinulid; pisi; kawad
Tanikala 	Sṛṅkhala (शृङ्खल) 	Kadena
Tingga 	Tivra (तीव्र) 	Tingga; bakal; asero
Tsampaka 	Campaka (चम्पक) 	Magnolia champaca
Upang 	Upa (उप) 	Patungo, malapit sa

Tamil

Bagay[65] 	வாகை (Vagai) 	Uri, klase; kalakal; pag-aari; hanapbuhay
Baril[65] 	வெடில் (Veḍil) 	Pagsabog
Bilanggo[65] 	விலங்கு (Vilaṅgu) 	Kadena sa paa; posas; kadenahan
Gulay[65] 	குழை (Kulai) 	Lumambot, malamasa, lutung-luto
Kalikam[8]:302 	காரிக்கம் (kārikkam) 	Di-kuladong simpleng telang bulak
Kawal[65] 	காவல் (Kāval) 	Bantay; tanod
Kawali[65] 	குவளை (Kuvaḷai) 	Lalagayan na may bungangang malawak; tasa
Kiyapo[65] 	கயப்பு (Kayappū) 	Bulaklak na pantubig
Mangga[65] 	மாங்காய் (Māngāi) 	Hilaw na mangga
Malunggay[65] 	முருங்கை (Murungai) 	Moringa oleifera
Misay[65] 	மீசை (Mīcai) 	Bigote
Palisay[65] 	பரிசை (Paricai) 	Kalasag
Puto[65] 	புட்டு (Puttu) 	Isang uri ng minatamis
Tupa[8]:303 	ஆட்டுப்பட்டி (Āṭṭu-p-paṭṭi) 	Isang kawan ng tupa

Arabe at Persyano

Agimat 	عَزِيمَة (Arabeng `azimah: mutya, gayuma, pangkukulam) 	Azimat (mutya)
Alak 	عرق (Arabeng `araq: alak) 	Arak (alak)
Anakura[69] 	ناخوذا (Persyanong nakhoodha: kapitan ng barko) 	Nakhoda (kapitan ng barko)
Daulat 	دولة (Arabeng Dawlah: pag-ikot, pagbaliktad ng kapalaran) 	Daulat (kaunlaran, kaligayahan)
Gumamela 	جميلة (Arabeng Jamiilah: maganda) 	
Hukom 	حكم (Arabeng Ḥukm: kahatulan) 	Hukum (kahatulan, batas)
Katan 	ختان (Arabeng Khatān: pagtutuli) 	
Kupya 	كوفية (Arabeng Kuufiyyah: gora, keffieh) 	Kopiah (gora)
Malim 	معلم (Arabeng Mu`allim: guro) 	Malim (pilotong pandagat)
Mansigit 	مسجد (Arabeng Masjid: moske) 	
Paham 	فَهْم (Arabeng Fahm: pag-unawa) 	Faham (agham, pag-unawa)
Pangadyi 	Tag. pang- + حاجي (Arabeng 'Ḥājjī: isang peregrino sa Mecca) 	Pengajian (pagtula, pagbasa)
Pinggan[70] 	ﭙﻨﮔان (Persyanong Pingān: tasa, mangkok) 	Pinggan (plato, platito)
Salabat 	شربة (Arabeng Sharbah: anumang inumin na walang alak) 	
Salamat[71] 	سلامة (Persyanong Salāmah: salamat, mula sa Arabeng Salāmāt سلامت:

kapayapaan at pagpapala (pambati o pampasalamat)
	
Salapi 	صرف (Arabeng Ṣarf, magbayad, kumita) 	
Salawal[70] 	سروال (Persyanong Sarwaal, pantalon) 	Seluar (salawal, pantalon)
Siyak 	شيخ (Arabeng Shaykh, matanda, maestro, guro, sheik) 	Siak (tagapag-alaga ng moske)
Sumbali 	سبحل (Arabeng 'Sabḥala', sabihin o ulitin ang "Subhanallah") 	
Sunat 	سنة (Arabeng Sunnah, tradisyon) 	Sunat (pagsusunat)

Tsino

Angkak 	紅麴/âng-khak (H) 	Angkak
Apyan 	鴉片/a-phiàn (H) 	Opyo
Ate 	阿姊/á-chí (H) 	Papangalan sa panganay na babae
Baktaw 	墨斗/ba̍k-táu (H) 	Baktaw
Bakya 	木屐/ba̍k-kia̍h (H) 	Bakya
Bataw 	扁豆/pà-taŭ (H) 	Bataw (Lablab purpureus)
Batsoy 	肉水/bà-cuì (H) 	Putahe kung saan ang pangunahing sangkap ay lomo ng baboy
Bihon 	米粉/bî-hún (H) 	Bihon
Biko 	米糕/bí-kō (H) 	Pinatamis na bibingka
Bilawo[76] 	米樓/bí-lâu (H) 	Literal na "suson/antas ng bigas"
Bimpo[78] 	面布/bīn-pǒ (H) 	Bimpo
Bithay[8]:338[79] 	米篩/bi-thaî (H) 	Salaan ng bigas
Bitso[76] 	米棗/bí-chó (H) 	Kakaning prinito na gawa sa galapong
Betsin 	味精/bī-cheng (H) 	Betsin
Bonsay 	盆栽/phûn-chai (H)(To Japanese 盆栽 (Bonsai) 	Bonsay
Buwisit[80] 	無衣食/bō-uî-sít (H) 	Walang damit o pagkain
Diko 	二哥/dī-kô (H) 	Papangalan sa ikalawa sa panganay na lalaki
Ditse 	二姊/dī–cì (H) 	Papangalan sa ikalawa sa panganay na babae
Ginto[81] 	金條/kim-tiâu (H) 	Barang ginto
Goto[76] 	牛肚/gû-tǒ͘ (H) 	Goto
Hikaw 	耳鉤/hǐ-kau (H) 	Hikaw
Hopya 	好餅/hō-pià (H) 	Matamis na tinapay na may munggo
Hukbo 	服務/hôk-bū (H) 	Serbisyo
Husi 	富絲/hù-si (H) 	Algodong de-kalidad
Huwepe 	火把/huè-pĕ (H) 	Sulo
Huweteng 	花檔/huê-tĕng (H) 	Huweteng
Ingkong 	𪜶公/in-kông (H) 	Ang kanilang ama
Inso 	𪜶嫂/in-só (H) 	Hipag sa kuya
Intsik 	𪜶叔/in-chek/in-chiak (H) 	Ang kanyang/kanilang tito
Katay[76] 	共刣/kā-thâi (H) 	Katay
Kintsay 	芹菜/khîn-chaĭ (H) 	Apyo (Apium graveolens)
Kiti 	雞弟/ke-tǐ (H) 	Sisiw
Kutsay 	韭菜/khû-chaĭ (H) 	Kutsay (Allium ramosum)
Kusot 	鋸屑/kù-sùt (H) 	Piyaos
Kuya 	哥兄/ko͘–hiaⁿ (H) 	Papangalan sa nakatatandang kapatid na lalaki
Lawin 	老鷹/laū-yêng (H) 	Anumang ibon mula sa Accipitridae o Falconidae
Lawlaw[82] 	老/laû (H) 	Luma
Lithaw[83] 	犁頭/lé-thaú (H) 	Araro
Lomi 	滷麵/ló͘-mī (H) 	Lor mee - Tsinong pansit
Loryat 	鬧熱/lāu-dia̍t (H) 	Abalang; dinadagsa; maingay
Lumpiya 	潤餅/lûn-pià (H) 	Prinito o sariwang lumpiya
Mami 	肉麵/mà-mĭ (H) 	Karne at pansit sa sabaw
Maselan[84] 	ma- + 西儂/se-lâng (H) 	Taga-kanluran; Kanluranin
Miswa 	麵線/mī-sòaⁿ (H) 	Miswa - Tsinong inasnang pansit
Pansit 	便食/pân-si̍t (H) 	Putahe na madaling lutuin i.e. pansit
Pakyaw[85] 	跋繳/pák-kiaù (H) 	Ibigay sa mga bungkos
Paslang[86] 	拍死人/phah-sí-lāng (H) 	Ipatay
Petsay[87] 	白菜/pē-chaĭ (H) 	Petsay (Brassica rapa subsp. pekinensis)
Pesa 	白煠魚/pē-sà-hí (H) 	Simpleng pinakuluang isda
Pinse 	硼砂/piên-sē (H) 	Pinse
Pisaw 	匕首/pì-siù (H) 	Patalim
Puntaw 	糞斗/pùn-taù (H) 	Pandakot
Puthaw[88] 	斧頭/pú-thâu (H) 	Palakol
Sampan 	舢板/san-pán (H) 	Tsinong barko
Samyo[89] 	糝藥粉/sám+iôq+hùn (H) 	Magwisik ng gamot na pulbos
Sangko 	三哥/sâ-kô (H) 	Papangalan sa ikatlo sa panganay na lalaki
Sanse 	三姊/sâ–cì (H) 	Papangalan sa ikatlo sa panganay na babae
Singki 	新客/sin-kheh (H) 	Bagong bisita o suki
Sitaw 	青豆/chî-taŭ (H) 	Sitaw (Vigna unguiculata subsp. sesquipedalis)
Siyaho 	姐夫/tsiá-hu (H) 	Bayaw
Siyakoy 	油炸粿/iû-cha̍h-kóe (H) 	Youtiao
Siyansi 	煎匙/chian-sî (H) 	Siyansi
Sotanghon 	蘇打粉/so͘-táⁿ-hún (H) 	Sotanghon
Suki[90] 	主客/chù–khè (H) 	Mahalagang suki
Sungki[78] 	伸牙/chûn-khì (H) 	Ngiping nakausli
Susi 	鎖匙/só–sî (H) 	Susi
Suwahe 	沙蝦/suā-hé (H) 	Suwahe (Metapenaeus ensis)
Suya 	衰啊/soe-a (H) 	Pananalitang "Ang malas!"
Siyokoy 	水鬼/cuí-kuì (H) 	Espiritu ng tubig; demonyo ng tubig
Siyomay 	燒賣/siō-maĭ (H) 	Siyomai
Siyopaw 	燒包/siō-paŭ (H) 	Siyopaw
Taho 	豆花/taū-hû (H) 	Tokwa
Tahure (bar. tahuri) 	豆花/taū-hû (H) 	Tokwa
Tanga[91] 	蟲仔/thâng-á (H) 	Maliit na insekto/kulisap/uod
Tanglaw 	燈籠/tiêng-laú (H) 	Lampara; Ilawan
Tanso 	銅索/táng-sò (H) 	Alambreng tanso
Tawsi 	豆豉/tāu-si (H) 	Utaw na pinreserba sa toyo
Timsim (bar. tingsim) 	灯心/tiêng-sîm (H) 	Timsim
Tinghoy 	燈火/tiêng-huè (H) 	Kingki
Tikoy 	甜粿/tiⁿ-kóe (H) 	Tikoy
Tito[76] 	豬肚/ti-tǒ͘ (H) 	Tripa ng baboy
Toge 	豆芽/tāu-gê (H) 	Toge
Tokwa 	豆乾/taū-kuâ (H) 	Tokwa
Totso 	豆油醋魚/taū-iū-chò-hí (H) 	Isdang niluto sa toyo at suka
Toyo 	豆油/tāu–iû (H) 	Toyo
Tsaa 	茶仔/chhâ-á (H) 	Tsaa
Tutsang 	頭鬃/thâu-chang (H) 	Buhok
Upo 	瓠瓜/ō-pú (H) 	Upo (Lagenaria siceraria)
Utaw 	黑豆/ō-taŭ (H) 	Utaw (Glycine max)
Wansoy (bar. unsoy, yansoy) 	芫荽/iān-suî (H) 	Kulantro (Coriandrum sativum)

Hapones

Dorobo 	泥棒 (dorobō) 	Magnanakaw; mangloloob; tulisan
Dyak en poy[93] 	じゃん拳ぽん (jankenpon) 	Bato–bato–pik
Kampay 	乾杯 (kanpai) 	Tagay!
Karaoke 	カラオケ (karaoke) 	Karaoke
Karate 	空手 (karate) 	Karate
Katana 	刀 (katana) 	Katana; isang espadang Hapones
Katol 	蚊取り線香 (katorisenkō) 	Katol
Kimona 	着物 (kimono) 	Kimono (o iba pang trad. na kasuotang Hapones)
Kirey 	奇麗 (kirei) 	Maganda; kaibig-ibig; marikit
Kokang 	交換 (kōkan) 	Kambalatse
Pampan 	ぱんぱん (panpan) 	(balbal) Patutot (lalo na noong kakatapos lamang ng WWII)
Shabu 	シャブ (shabu) 	(balbal) Methamphetamine hydrochloride
Taksan-taksan 	沢山 (takusan) 	Marami
Tansan 	炭酸 (tansan) 	Karbonadong tubig
Tsunami 	津波 (tsunami) 	Tsunami

Nahuatl

Abukado 	Ahuacatl 	Aguacate
Akapulko (var. kapurko) 	Acapolco 	Acapulco
Alpasotis (var. pasotis) 	Epazotl 	Epazote
Atole[95] 	Atolli 	Atole
Atsuwete 	Achiotl 	Achiote
Guwatsinanggo 	Cuauchilnacatl 	Guachinango
Kakaw 	Cacáhuatl 	Cacao
Kakawati (bar. kakawate) 	Cacáhuatl 	Cacahuate
Kalatsutsi (bar. kalanotse) 	Cacaloxochitl 	Cacalosúchil
Kamatis 	Tomatl 	Tomate
Kamatsile 	Cuamóchitl 	Guamúchil
Kamote 	Camotli 	Camote
Koyote (var. kayote) 	Coyotl 	Coyote
Kulitis 	Quilitl 	Quelite
Mekate 	Mecatl 	Mecate
Mehiko 	Mēxihco 	Mexico
Nanay[96][97] 	Nantli 	Nana
Paruparo[98][94](bar. paparo) 	Papalotl 	Papalote
Petate[99] 	Petlatl 	Petate
Peyote 	Peyotl 	Peyote
Pitaka 	Petlacalli 	Petaca
Sakate 	Zacatl 	Zacate
Sangkaka 	Chiancaca 	Chancaca
Sapote 	Tzapotl 	Zapote
Sayote 	Chayotli 	Chayote
Sili 	Chīlli 	Chile
Singkamas 	Xicamatl 	Jicama
Sisiwa 	Chichiua 	Chichigua
Tamalis (bar. tamales) 	Tamalli 	Tamal
Tapangko[100] 	Tlapanco 	Tapanco
Tatay[96][101] 	Tahtli 	Tata
Tisa 	Tizatl 	Tiza
Tiyangge (bar. tsangge) 	Tianquiztli 	Tianguis
Tokayo (bar. tukayo, katukayo) 	Tocayotia 	Tocayo
Tsiklet (bar. tsikle) 	Chictli 	Chicle
Tsiko 	Tzicozapotl 	Chicozapote
Tsokolate 	Xocolatl 	Chocolate
